111111111111111111111111111111111111111
100000000000000000000000000000000000001
100000000000000000000000000000000000001
100000000000000111111110000000000000001
100000000000000000000000000000011111111
100001111111100000000000000000000000001
100000000000000000111110000000000000001
100000000000000000000000001111111100001
1000000111111110000000000000000P0000001
1000000000000000000000C0000000000E00001
100000000000000000000000000000000000001
111111111111111111111111111111111111111